Disease,Sex,<1,1 - 4,5 -16,17 -49,50 - 69,70+,N/Av,Total
Cholera (A00),Male,0,0,0,0,0,0,0,0
Typhoid and para typhoid fever (A01),Male,16,128,267,520,155,23,1,1110
Typhoid and para typhoid fever (A01),Female,9,109,208,351,148,23,0,848
Shigellosis (A03),Male,181,326,229,153,95,43,0,1027
Shigellosis (A03),Female,138,285,219,163,107,58,1,971
Amoebiasis with liver abscess(A06.4),Male,3,4,4,16,30,4,0,61
Amoebiasis with liver abscess(A06.4),Female,2,7,1,7,5,4,0,26
"Amoebiasis others (A06.0-A06.3,A06.5-A06.9)",Male,68,85,85,117,121,57,0,533
"Amoebiasis others (A06.0-A06.3,A06.5-A06.9)",Female,59,90,106,141,122,35,0,553
"Food poisoning (A02.0,A05)",Male,60,280,498,667,242,67,1,1815
"Food poisoning (A02.0,A05)",Female,91,311,648,783,250,95,1,2179
Diarrhoea and gastroenteritis of presumed infectious origin (A09),Male,6649,14200,9303,12090,7001,3981,31,53255
Diarrhoea and gastroenteritis of presumed infectious origin (A09),Female,5058,12761,9276,14003,9938,5807,45,56888
"Other intestinal infectious diseases (A04,A07,A08)",Male,322,670,452,588,301,101,1,2435
"Other intestinal infectious diseases (A04,A07,A08)",Female,255,620,417,747,447,194,0,2680
"Tuberculosis of lung confirmed by sputum microscopy, culture,histologically or by unspecified means  (A15.0-A15.3)",Male,11,7,27,1109,965,243,0,2362
"Tuberculosis of lung confirmed by sputum microscopy, culture,histologically or by unspecified means  (A15.0-A15.3)",Female,2,2,36,311,356,127,0,834
Tuberculosis of lung not confirmed (A16-A16.2),Male,1,4,18,704,748,234,0,1709
Tuberculosis of lung not confirmed (A16-A16.2),Female,3,8,34,291,269,92,0,697
Other Respiratory Tuberculosis confirmed bacteriologically and histologically   (A15.4-A15.9),Male,6,20,28,99,111,43,0,307
Other Respiratory Tuberculosis confirmed bacteriologically and histologically   (A15.4-A15.9),Female,10,22,36,81,75,40,0,264
Other Respiratory Tuberculosis not confirmed (A16.3-A16.9),Male,0,8,22,387,340,99,0,856
Other Respiratory Tuberculosis not confirmed (A16.3-A16.9),Female,1,3,20,145,115,47,0,331
Tuberculosis of nervous system (A17),Male,0,0,3,47,21,5,0,76
Tuberculosis of nervous system (A17),Female,0,1,5,24,18,1,0,49
Tuberculosis of other organs (A18),Male,2,3,9,114,125,43,0,296
Tuberculosis of other organs (A18),Female,0,3,10,62,62,15,1,153
Miliary tuberculosis (A19),Male,0,0,1,16,16,3,0,36
Miliary tuberculosis (A19),Female,1,1,3,17,9,5,0,36
Plague (A20),Male,1,0,0,0,1,1,0,3
Plague (A20),Female,0,0,0,2,0,0,0,2
Anthrax (A22),Male,0,0,0,0,0,0,0,0
Anthrax (A22),Female,0,0,0,0,0,0,0,0
Brucellosis (A23),Male,0,0,0,0,0,2,0,2
Brucellosis (A23),Female,0,1,0,0,0,1,0,2
Leptospirosis (A27),Male,4,5,274,4739,1813,220,2,7057
Leptospirosis (A27),Female,1,8,55,677,430,68,0,1239
Leprosy (A30),Male,1,1,24,232,120,35,0,413
Leprosy (A30),Female,0,1,28,140,52,13,0,234
Tetanus neonatorum (A33),Male,7,0,0,0,0,0,0,7
Tetanus neonatorum (A33),Female,6,0,0,0,0,0,0,6
Obsterical tetanus (A34),Male,0,0,0,0,0,0,0,0
Obsterical tetanus (A34),Female,0,0,0,0,0,0,0,0
Other tetanus (A35),Male,0,19,25,36,22,8,5,115
Other tetanus (A35),Female,0,14,11,16,9,1,0,51
Diphtheria (A36),Male,0,0,2,0,0,1,0,3
Diphtheria (A36),Female,0,0,0,0,0,2,0,2
Whooping cough(A37),Male,13,6,5,0,1,1,0,26
Whooping cough(A37),Female,18,1,2,3,0,0,0,24
Meningococcal infections (A39),Male,6,7,35,20,11,7,0,86
Meningococcal infections (A39),Female,2,17,12,20,18,11,0,80
"Septicaemia (A40,A41)",Male,1166,442,245,235,250,201,2,2541
"Septicaemia (A40,A41)",Female,1008,374,212,209,299,226,0,2328
"Other bacterial diseases (A21,A24-A26,A28,A31,A32,A38,A42-A49)",Male,26,114,154,188,149,43,0,674
"Other bacterial diseases (A21,A24-A26,A28,A31,A32,A38,A42-A49)",Female,27,84,135,189,146,52,0,633
Congenital Syphilis(A50),Male,2,1,0,0,0,0,0,3
Congenital Syphilis(A50),Female,1,1,1,0,0,0,0,3
Early Syphilis(A51),Male,0,0,3,1,8,2,0,14
Early Syphilis(A51),Female,0,0,0,5,5,0,0,10
Late Syphilis(A52),Male,0,0,0,1,0,0,0,1
Late Syphilis(A52),Female,0,0,0,0,1,0,0,1
Other and unspecified Syphilis(A53),Male,0,0,2,22,4,1,0,29
Other and unspecified Syphilis(A53),Female,0,0,0,12,3,1,0,16
Gonococcal infections (A54),Male,0,0,0,5,2,0,0,7
Gonococcal infections (A54),Female,0,0,0,4,1,0,0,5
Chlamydial lymphogranuloma (venereum)(A55),Male,0,1,0,6,9,0,0,16
Chlamydial lymphogranuloma (venereum)(A55),Female,1,0,2,4,16,2,0,25
Other sexually transmitted chlamydia diseases(A56),Male,0,0,0,0,0,0,0,0
Other sexually transmitted chlamydia diseases(A56),Female,0,0,0,5,5,3,0,13
Chancroid(A57),Male,0,0,0,2,1,1,0,4
Chancroid(A57),Female,0,0,0,1,0,0,0,1
Granuloma inguinale(A58),Male,0,0,1,8,9,0,0,18
Granuloma inguinale(A58),Female,0,2,0,0,0,0,0,2
Trichomoniasis(A59),Male,0,0,0,0,0,0,0,0
Trichomoniasis(A59),Female,0,0,0,1,1,0,0,2
Anogenital herpesviral (herpes simplex) infection(A60),Male,0,1,1,30,4,1,0,37
Anogenital herpesviral (herpes simplex) infection(A60),Female,1,0,3,101,12,0,0,117
"Other predominantly sexually transmitted diseases, not elsewhere classified(A63)",Male,0,0,0,6,2,0,0,8
"Other predominantly sexually transmitted diseases, not elsewhere classified(A63)",Female,0,0,1,7,1,0,0,9
Unspecified sexually transmitted disease(A64),Male,0,0,1,5,3,0,0,9
Unspecified sexually transmitted disease(A64),Female,0,0,3,21,3,0,0,27
Rabies (A82),Male,0,2,13,8,1,0,0,24
Rabies (A82),Female,0,0,6,7,2,0,0,15
Viral encephalitis (includes Japanese Encephalitis)       (A83-A86),Male,12,20,37,71,33,27,0,200
Viral encephalitis (includes Japanese Encephalitis)       (A83-A86),Female,14,15,21,34,31,34,1,150
Viral meningitis (A87),Male,78,108,157,112,57,12,2,526
Viral meningitis (A87),Female,59,111,76,119,83,17,0,465
Dengue fever (A90),Male,96,843,3637,15467,2033,310,7,22393
Dengue fever (A90),Female,76,746,2636,7092,1859,296,3,12708
Dengue haemorrhagic fever (A91),Male,67,179,1040,2308,243,29,0,3866
Dengue haemorrhagic fever (A91),Female,55,195,895,1215,253,35,0,2648
"Other arthropod-borne viral fever and viral haemorrhagic fever (A92-A94,A96-A99)",Male,137,314,363,686,259,93,0,1852
"Other arthropod-borne viral fever and viral haemorrhagic fever (A92-A94,A96-A99)",Female,140,348,393,650,355,136,11,2033
Varicella (Chickenpox) (B01),Male,71,109,206,839,215,97,3,1540
Varicella (Chickenpox) (B01),Female,68,80,124,478,145,67,0,962
Zoster (herpese zoster) (B02),Male,12,25,64,427,408,153,6,1095
Zoster (herpese zoster) (B02),Female,5,23,57,396,535,253,1,1270
Measles (B05),Male,565,299,230,1628,30,11,0,2763
Measles (B05),Female,457,181,176,1138,32,8,0,1992
Rubella (B06),Male,1,0,7,21,2,3,0,34
Rubella (B06),Female,6,2,2,4,2,0,0,16
Congenital rubella (P35.0),Male,2,3,0,0,0,0,0,5
Congenital rubella (P35.0),Female,0,0,0,0,0,0,0,0
Acute hepatitis A (B15),Male,9,36,230,689,72,11,0,1047
Acute hepatitis A (B15),Female,7,20,105,302,83,12,0,529
Acute hepatitis B (B16),Male,0,2,14,152,38,11,0,217
Acute hepatitis B (B16),Female,1,0,10,73,22,7,0,113
"Chronic, other acute and unspecified viral hepatitis(B17-B19)",Male,1,7,119,715,76,18,0,936
"Chronic, other acute and unspecified viral hepatitis(B17-B19)",Female,1,18,88,281,40,9,0,437
Human immunodeficiency virus (HIV) (B20-B24),Male,0,0,2,74,19,0,0,95
Human immunodeficiency virus (HIV) (B20-B24),Female,1,1,0,57,22,2,0,83
Mumps (B26),Male,26,99,180,210,52,19,0,586
Mumps (B26),Female,46,122,122,169,70,22,0,551
"Other viral diseases(includes viral fever)(A81,A88,A89,B00,B03,B04,B07-09,B25,B27-B34)",Male,7668,21095,23483,50427,18025,6031,77,126806
"Other viral diseases(includes viral fever)(A81,A88,A89,B00,B03,B04,B07-09,B25,B27-B34)",Female,6716,18885,18705,34106,17055,6400,42,101909
Mycosis (B35-B49),Male,36,101,148,595,296,82,1,1259
Mycosis (B35-B49),Female,39,89,128,949,197,68,1,1471
Malaria (B50-B54),Male,0,2,8,63,9,0,0,82
Malaria (B50-B54),Female,0,1,6,9,4,4,0,24
Filariasis (B74),Male,10,23,36,43,29,34,0,175
Filariasis (B74),Female,8,14,7,8,7,1,0,45
"Helminthiasis (B76,B77,B79,B80)",Male,2,44,67,17,14,0,0,144
"Helminthiasis (B76,B77,B79,B80)",Female,0,32,47,41,6,5,0,131
Scabies (B86),Male,120,116,123,171,80,43,1,654
Scabies (B86),Female,133,93,73,111,29,12,0,451
Sequelae of infectious and parasitic diseases (B90-B94),Male,1,12,19,33,47,15,0,127
Sequelae of infectious and parasitic diseases (B90-B94),Female,1,10,18,22,31,10,0,92
"Other infectious and parasitic diseases (A02.1-A02.9,A65-A79,B55-B73,B75,B78,B81-B85,B87-B89,B95-B99)",Male,94,341,547,1257,554,132,3,2928
"Other infectious and parasitic diseases (A02.1-A02.9,A65-A79,B55-B73,B75,B78,B81-B85,B87-B89,B95-B99)",Female,81,328,427,1134,648,125,0,2743
"Malignant neoplasm of lip, oral cavity and pharynx (C00-C14)",Male,3,12,40,1314,3726,873,2,5970
"Malignant neoplasm of lip, oral cavity and pharynx (C00-C14)",Female,0,4,17,321,743,309,0,1394
Malaignant neoplasm of oesophagus (C15),Male,0,1,3,341,1706,550,2,2603
Malaignant neoplasm of oesophagus (C15),Female,0,0,7,194,1117,523,1,1842
Malignant neoplasm of stomach (C16),Male,0,0,6,152,538,129,0,825
Malignant neoplasm of stomach (C16),Female,0,0,2,78,184,65,1,330
Malignant neoplasm of colon (C18),Male,1,0,0,395,1088,253,0,1737
Malignant neoplasm of colon (C18),Female,1,0,2,386,1216,219,0,1824
"Malignant neoplasm of rectosigmoid junction,rectum, anus and anal canal (C19-C21)",Male,1,0,4,595,1479,455,1,2535
"Malignant neoplasm of rectosigmoid junction,rectum, anus and anal canal (C19-C21)",Female,0,1,2,421,1131,279,0,1834
Malignant neoplasm of liver and intrahepatic bile duct (C22),Male,3,24,2,52,439,153,0,673
Malignant neoplasm of liver and intrahepatic bile duct (C22),Female,9,52,9,60,162,55,0,347
Malignant neoplasm of pancreas (C25),Male,0,1,2,88,201,55,0,347
Malignant neoplasm of pancreas (C25),Female,0,1,4,67,144,24,1,241
"Other malignant neoplasm of digestive organs (C17,C23,C24,C26)",Male,0,0,0,59,143,32,0,234
"Other malignant neoplasm of digestive organs (C17,C23,C24,C26)",Female,0,0,3,67,138,46,0,254
Malignant neoplasm of larnyx (C32),Male,0,2,8,172,856,201,0,1239
Malignant neoplasm of larnyx (C32),Female,0,0,9,44,84,26,0,163
"Malignant neoplasm of trachea, bronchus and lung (C33-C34)",Male,1,4,25,466,2427,701,1,3625
"Malignant neoplasm of trachea, bronchus and lung (C33-C34)",Female,2,1,7,272,728,192,0,1202
"Malignant neoplasm of other respiratory and intrathoracic organs (C30,C31,C37-C39)",Male,0,5,4,125,90,27,0,251
"Malignant neoplasm of other respiratory and intrathoracic organs (C30,C31,C37-C39)",Female,2,1,5,42,68,10,0,128
"Malignant neoplasm of bone and articular cartilage (C40,C41)",Male,0,13,170,310,133,55,2,683
"Malignant neoplasm of bone and articular cartilage (C40,C41)",Female,2,12,225,129,51,18,0,437
"Melanoma and other malignant neoplasm of skin (C43,C44)",Male,0,3,7,118,316,139,0,583
"Melanoma and other malignant neoplasm of skin (C43,C44)",Female,1,6,10,70,154,57,0,298
"Malignant neoplasm of masothelial and soft  tissue (C45,C49)",Male,4,54,47,233,240,81,0,659
"Malignant neoplasm of masothelial and soft  tissue (C45,C49)",Female,2,33,74,215,199,44,0,567
Malignant neoplasm of breast (C50),Male,0,0,1,41,79,38,0,159
Malignant neoplasm of breast (C50),Female,0,2,7,3973,6096,1017,0,11095
Malignant neoplasm of cervix uteri (C53),Male,0,0,0,0,0,0,0,0
Malignant neoplasm of cervix uteri (C53),Female,0,1,3,790,2023,462,3,3282
"Malignant neoplasm of other and unspecified parts of uterus (C54,C55)",Male,0,0,0,0,0,0,0,0
"Malignant neoplasm of other and unspecified parts of uterus (C54,C55)",Female,0,2,3,274,1075,237,1,1592
Malignant neoplasm of placenta (C58),Male,0,0,0,0,0,0,0,0
Malignant neoplasm of placenta (C58),Female,0,0,0,132,18,2,0,152
"Malignant neoplasm of female genital organs (C51,C52,C56,C57)",Male,0,0,0,0,0,0,0,0
"Malignant neoplasm of female genital organs (C51,C52,C56,C57)",Female,3,6,43,1736,3544,631,0,5963
Malignant neoplasm of prostate (C61),Male,0,0,3,83,809,855,1,1751
Malignant neoplasm of prostate (C61),Female,0,0,0,0,0,0,0,0
"Malignant neoplasm of other male genital organs (C60,C62,C63)",Male,10,2,12,191,159,67,1,442
"Malignant neoplasm of other male genital organs (C60,C62,C63)",Female,0,0,0,0,0,0,0,0
Malignant neoplasm of bladder (C67),Male,0,0,6,126,892,564,0,1588
Malignant neoplasm of bladder (C67),Female,0,1,8,70,219,156,0,454
"Malignant neoplasm of other parts of the urinary tract (C64-C66,C68)",Male,8,28,26,75,215,62,0,414
"Malignant neoplasm of other parts of the urinary tract (C64-C66,C68)",Female,11,61,52,38,96,30,0,288
Malignant neoplasm of eye and adnexa (C69),Male,41,59,37,6,20,4,0,167
Malignant neoplasm of eye and adnexa (C69),Female,14,108,19,8,15,3,0,167
Malignant neoplasm of brain(C71),Male,6,28,123,288,225,50,1,721
Malignant neoplasm of brain(C71),Female,2,53,96,184,156,41,0,532
"Malignant neoplasm of other parts of the central nervous system (C70,C72)",Male,0,0,2,14,22,1,0,39
"Malignant neoplasm of other parts of the central nervous system (C70,C72)",Female,0,0,1,26,25,8,1,61
Malignant neoplasm of thyroid gland (C73),Male,0,0,10,145,205,62,0,422
Malignant neoplasm of thyroid gland (C73),Female,0,1,34,627,426,84,0,1172
"Malignant neoplasm of other endocrine, ill-defined, secondary and unspecified sites (C74-C80,C97)",Male,23,122,45,288,732,189,0,1399
"Malignant neoplasm of other endocrine, ill-defined, secondary and unspecified sites (C74-C80,C97)",Female,16,45,48,232,475,133,1,950
Hodgkin's disease (C81),Male,1,2,75,404,260,29,1,772
Hodgkin's disease (C81),Female,1,1,9,190,125,35,0,361
Leukaemia (C91-C95),Male,24,767,1328,960,681,189,0,3949
Leukaemia (C91-C95),Female,8,504,785,504,499,165,1,2466
"Malignant neoplasm of other lymphoid haematopoietic and related tissue (C82-C85,C88-C90,C96)",Male,3,29,165,782,1627,488,0,3094
"Malignant neoplasm of other lymphoid haematopoietic and related tissue (C82-C85,C88-C90,C96)",Female,13,33,87,590,1416,435,0,2574
In situ neoplasm (D00-D09),Male,1,0,2,21,40,12,0,76
In situ neoplasm (D00-D09),Female,0,1,2,50,57,23,0,133
Benign neoplasm (D10-D36),Male,61,127,196,1295,939,243,2,2863
Benign neoplasm (D10-D36),Female,76,120,237,5009,1792,242,1,7477
Neoplasm of uncertain or unknown behaviour (D37-D48),Male,7,30,64,668,1088,451,0,2308
Neoplasm of uncertain or unknown behaviour (D37-D48),Female,9,31,46,497,668,362,1,1614
Iron deficiency anaemias (D50),Male,18,123,149,450,809,598,5,2152
Iron deficiency anaemias (D50),Female,10,94,212,1648,981,644,4,3593
Thalasemia (D56),Male,50,463,1335,543,44,20,0,2455
Thalasemia (D56),Female,62,444,1456,621,90,30,1,2704
"Other anaemias (D51-D55,D57-D64)",Male,126,170,304,979,1815,1298,6,4698
"Other anaemias (D51-D55,D57-D64)",Female,71,75,347,2815,2254,1685,0,7247
Haemorrhagic conditions and other diseases of blood and blood forming organs and certain disorders involving immune mechanism (D65-D89),Male,122,606,1450,1715,441,165,2,4501
Haemorrhagic conditions and other diseases of blood and blood forming organs and certain disorders involving immune mechanism (D65-D89),Female,101,191,501,865,374,146,2,2180
Iodine-deficiency related thyroid disorders (E00-E02),Male,0,5,6,46,35,16,0,108
Iodine-deficiency related thyroid disorders (E00-E02),Female,4,9,35,121,110,53,0,332
Thyrotoxicosis (E05),Male,1,0,9,184,124,22,0,340
Thyrotoxicosis (E05),Female,1,3,36,502,380,90,0,1012
"Other disorders of thyroid (E03,E04,E06,E07)",Male,27,24,117,846,665,152,0,1831
"Other disorders of thyroid (E03,E04,E06,E07)",Female,26,28,132,3912,2292,331,2,6723
Insulin-dependent diabetes mellitus(E10),Male,3,14,112,2129,3855,1582,38,7733
Insulin-dependent diabetes mellitus(E10),Female,5,25,172,2457,4693,1816,40,9208
Non-insulin-dependent diabetes mellitus(E11),Male,2,8,110,3691,6115,2185,30,12141
Non-insulin-dependent diabetes mellitus(E11),Female,5,18,83,4050,7531,2514,47,14248
Malnutrition-related diabetes mellitus(E12),Male,1,0,6,141,254,181,7,590
Malnutrition-related diabetes mellitus(E12),Female,0,0,11,157,261,123,71,623
Other specified diabetes mellitus(E13),Male,1,3,14,243,523,179,1,964
Other specified diabetes mellitus(E13),Female,0,6,26,632,692,203,1,1560
Unspecified diabetes mellitus(E14),Male,3,25,148,4737,8827,3212,27,16979
Unspecified diabetes mellitus(E14),Female,6,18,215,5020,10769,3528,14,19570
Kwashiorkor(E40),Male,4,1,4,14,19,8,0,50
Kwashiorkor(E40),Female,0,0,0,11,23,7,0,41
Nutritional marasmus(E41),Male,0,0,0,25,53,18,0,96
Nutritional marasmus(E41),Female,0,0,2,32,69,24,0,127
Marasmic kwashiorkor(E42),Male,0,0,0,0,0,0,0,0
Marasmic kwashiorkor(E42),Female,0,3,0,0,2,2,0,7
Unspecified severe protein-energy malnutrition(E43),Male,3,41,1,3,1,2,0,51
Unspecified severe protein-energy malnutrition(E43),Female,1,9,5,21,39,18,0,93
Protin-energy malnutrition of moderate and mild degree(E44),Male,1,1,8,78,161,69,0,318
Protin-energy malnutrition of moderate and mild degree(E44),Female,1,2,1,41,81,28,0,154
Retarded development following protein-energy malnutrition(E45),Male,1,3,0,0,2,2,0,8
Retarded development following protein-energy malnutrition(E45),Female,0,1,2,0,0,0,0,3
Unspecified protin-energy malnutrition(E46),Male,13,22,5,1,3,6,0,50
Unspecified protin-energy malnutrition(E46),Female,2,19,19,21,20,5,0,86
Vitamin deficiencies (E50-E56),Male,5,32,65,72,60,55,3,292
Vitamin deficiencies (E50-E56),Female,7,31,37,69,68,34,0,246
"Other endocrine, nutritional and metabolic disorders (E15-E34,E58-E89)",Male,180,235,487,1741,2345,1116,33,6137
"Other endocrine, nutritional and metabolic disorders (E15-E34,E58-E89)",Female,152,237,538,2299,2488,1561,12,7287
"Dementia (F01,F03)",Male,0,0,0,124,229,203,2,558
"Dementia (F01,F03)",Female,0,0,3,77,207,233,3,523
Mental and behavioural disorders due to use of alcohol (F10),Male,0,0,72,4400,2241,300,40,7053
Mental and behavioural disorders due to use of alcohol (F10),Female,0,0,10,230,170,74,5,489
Mental and behavioural disorders due to other psychoactive substance use (F11-F19),Male,0,0,21,650,218,52,4,945
Mental and behavioural disorders due to other psychoactive substance use (F11-F19),Female,0,1,19,283,156,45,3,507
"Schizophrenia, schizotypal and delusional disorders (F20-F29)",Male,0,0,74,5302,1740,237,58,7411
"Schizophrenia, schizotypal and delusional disorders (F20-F29)",Female,0,0,111,3735,1815,256,20,5937
Mood (affective) disorders (F30-F39),Male,0,0,137,4286,1874,352,21,6670
Mood (affective) disorders (F30-F39),Female,0,0,269,4905,2350,491,19,8034
"Neurotic, stress-related somatoform disorders (F40-F48)",Male,0,0,83,488,155,65,8,799
"Neurotic, stress-related somatoform disorders (F40-F48)",Female,0,0,199,811,259,76,4,1349
Mental retardation (F70-F79),Male,1,8,24,245,32,8,8,326
Mental retardation (F70-F79),Female,1,2,19,129,38,5,3,197
Behavioural and emotional disorders with onset usually occuring in childhood and adolescence (F90-F98),Male,0,12,84,148,34,18,7,303
Behavioural and emotional disorders with onset usually occuring in childhood and adolescence (F90-F98),Female,0,14,78,146,67,25,2,332
"Other mental and behavioural disorders (F04-F09,F50-F69,F80-F89,F99)",Male,0,42,170,1538,638,192,29,2609
"Other mental and behavioural disorders (F04-F09,F50-F69,F80-F89,F99)",Female,0,26,169,1544,612,197,25,2573
"Bacterial meningitis not elsewhere classified (G00,G03)",Male,584,413,559,342,133,56,1,2088
"Bacterial meningitis not elsewhere classified (G00,G03)",Female,435,287,286,268,139,80,0,1495
"Encephalitis,myelitis and encephalomyelitis (G04)",Male,18,52,185,280,168,85,0,788
"Encephalitis,myelitis and encephalomyelitis (G04)",Female,24,52,126,166,153,86,1,608
Intracranial and intraspinal abscess and granuloma(G06),Male,9,8,42,86,48,20,0,213
Intracranial and intraspinal abscess and granuloma(G06),Female,5,12,29,52,25,4,1,128
Parkinson's disease (G20),Male,0,0,0,77,222,188,2,489
Parkinson's disease (G20),Female,0,0,0,50,208,171,3,432
Multiple sclerosis (G35),Male,0,0,12,72,37,12,4,137
Multiple sclerosis (G35),Female,0,0,7,105,43,16,4,175
Epilepsy (G40-G41),Male,129,1181,2072,6320,2562,825,45,13134
Epilepsy (G40-G41),Female,121,959,1836,4067,1599,732,7,9321
"Migraine and headache syndrome (G43,G44)",Male,0,7,685,2709,1103,311,11,4826
"Migraine and headache syndrome (G43,G44)",Female,0,9,916,4978,1932,425,5,8265
Transient cerebral ischaemic attacks and related syndromes (G45),Male,1,0,26,605,1591,997,5,3225
Transient cerebral ischaemic attacks and related syndromes (G45),Female,1,1,37,598,1257,1104,11,3009
"Nerve, nerve root and plaxus disorders (G50-G58)",Male,12,45,120,1387,1114,307,0,2985
"Nerve, nerve root and plaxus disorders (G50-G58)",Female,15,61,152,2454,2127,338,0,5147
Cerebral palsy and other paralytic syndromes (G80-G83),Male,30,137,143,365,400,196,0,1271
Cerebral palsy and other paralytic syndromes (G80-G83),Female,23,78,136,198,197,150,0,782
"Other diseases of nervous system (G08,G12,G21-G31,G36,G37,G47,G60-G72,G90-G98)",Male,109,205,372,1190,1300,606,9,3791
"Other diseases of nervous system (G08,G12,G21-G31,G36,G37,G47,G60-G72,G90-G98)",Female,106,137,304,1173,1156,574,3,3453
Keratitis and other disorders of sclera and cornea      (H15-H18),Male,45,253,750,3580,1876,610,0,7114
Keratitis and other disorders of sclera and cornea      (H15-H18),Female,35,175,501,1603,1287,586,2,4189
Cataract and other disorders of lens (H25-H27),Male,33,114,364,2482,16398,10705,6,30102
Cataract and other disorders of lens (H25-H27),Female,23,102,282,3035,23552,14047,7,41048
Retinal detachment and breaks (H33),Male,5,13,85,315,524,191,0,1133
Retinal detachment and breaks (H33),Female,3,14,50,152,323,119,0,661
Glaucoma (H40),Male,1,15,57,242,698,461,0,1474
Glaucoma (H40),Female,4,19,44,239,660,479,1,1446
Strabismus (H49-H50),Male,4,57,95,170,55,5,0,386
Strabismus (H49-H50),Female,10,75,126,152,67,23,0,453
"Other diseases of the eye and adnexa (H00-H11,H20,H21,H30,H31,H34,H35,H43-H47,H51-H59)",Male,536,1590,4006,11826,8697,3324,5,29984
"Other diseases of the eye and adnexa (H00-H11,H20,H21,H30,H31,H34,H35,H43-H47,H51-H59)",Female,557,1314,2706,8064,9101,3559,2,25303
Otitis media and other disorders of middle ear and mastoid (H65-H74),Male,648,1694,1957,3137,1384,480,5,9305
Otitis media and other disorders of middle ear and mastoid (H65-H74),Female,584,1457,1500,3225,1498,416,12,8692
"Hearing loss (H90,H91)",Male,19,75,108,232,142,64,0,640
"Hearing loss (H90,H91)",Female,9,92,116,229,198,79,0,723
"Other diseases of the ear and mastoid process (H60,H61,H80-H83,H92-H95)",Male,317,1107,2087,3439,2106,834,6,9896
"Other diseases of the ear and mastoid process (H60,H61,H80-H83,H92-H95)",Female,288,991,1837,4165,2858,1109,2,11250
Acute rheumatic fever (I00-I02),Male,0,18,203,140,100,29,0,490
Acute rheumatic fever (I00-I02),Female,0,17,228,254,169,63,0,731
Chronic rheumatic heart disease (I05-I09),Male,0,0,39,271,303,87,5,705
Chronic rheumatic heart disease (I05-I09),Female,0,3,34,411,452,222,1,1123
Essential hypertension (I10),Male,0,0,0,7702,17522,10925,181,36330
Essential hypertension (I10),Female,0,0,0,10333,25454,17520,301,53608
Hypertensive heart disease (I11),Male,0,0,10,602,1335,945,13,2905
Hypertensive heart disease (I11),Female,0,0,4,803,1456,1102,37,3402
Other hypertensive diseases (I12-I15),Male,0,0,9,371,821,621,64,1886
Other hypertensive diseases (I12-I15),Female,0,0,10,339,695,448,23,1515
"Acute myocardial infarction (I21,I22)",Male,0,0,13,3596,9657,3822,14,17102
"Acute myocardial infarction (I21,I22)",Female,0,0,20,1393,4599,3286,18,9316
"Other ischaemic heart disease  (I20,I23-I25)",Male,0,0,67,6934,19828,9943,67,36839
"Other ischaemic heart disease  (I20,I23-I25)",Female,0,0,60,6788,17215,10258,103,34424
Pulmonary embolism (I26),Male,0,0,2,46,95,59,0,202
Pulmonary embolism (I26),Female,0,0,1,85,107,64,0,257
Cor pulmonale (I27.9),Male,1,1,4,71,287,257,3,624
Cor pulmonale (I27.9),Female,0,4,0,26,118,167,2,317
Heart failure (I50),Male,8,8,20,854,3474,2724,24,7112
Heart failure (I50),Female,11,8,29,626,2729,2803,20,6226
"Other heart diseases (I27.0-I27.8, I28-I49,I51)",Male,44,48,156,3115,4839,2525,16,10743
"Other heart diseases (I27.0-I27.8, I28-I49,I51)",Female,46,34,130,2744,4014,2475,25,9468
Cerebroavascular disease (I60-I69),Male,4,23,58,2699,10665,7823,149,21421
Cerebroavascular disease (I60-I69),Female,5,10,48,1603,6083,7511,17,15277
Atherosclerosis (I70),Male,0,0,1,37,51,35,0,124
Atherosclerosis (I70),Female,0,0,0,29,51,43,0,123
Arterial embolism and thrombosis (I74),Male,0,0,1,44,65,6,0,116
Arterial embolism and thrombosis (I74),Female,1,1,0,37,29,7,0,75
"Other diseases of arteries, artherosclerosis and capillaries (I71-I73,I77,I78)",Male,1,2,10,285,668,281,0,1247
"Other diseases of arteries, artherosclerosis and capillaries (I71-I73,I77,I78)",Female,0,4,11,206,256,103,0,580
"Phlebitis, thrombophlebitis, venous embolism and thrombosis (I80-I82)",Male,2,6,48,423,374,122,1,976
"Phlebitis, thrombophlebitis, venous embolism and thrombosis (I80-I82)",Female,0,5,32,494,310,124,0,965
Vericose veins of lower extremities (I83),Male,2,7,18,2299,2906,868,14,6114
Vericose veins of lower extremities (I83),Female,1,3,15,2782,2900,592,1,6294
Haemorrhoids (I84),Male,4,11,40,5018,5007,1788,17,11885
Haemorrhoids (I84),Female,0,8,63,2467,1771,627,1,4937
Other diseases of the circulatory system (I85-I99),Male,23,112,269,1218,1499,483,16,3620
Other diseases of the circulatory system (I85-I99),Female,17,85,213,880,1012,418,5,2630
Acute sinusitis and acute tonsillitis (J01-J03),Male,310,2952,3136,3934,1389,430,5,12156
Acute sinusitis and acute tonsillitis (J01-J03),Female,180,2084,2755,4467,1817,556,14,11873
"Other acute upper respiratory infections (J00,J02,J04-J06)",Male,6057,9618,7052,7571,4844,2433,45,37620
"Other acute upper respiratory infections (J00,J02,J04-J06)",Female,5123,7993,6231,8546,5437,2607,86,36023
Influenza (J10-J11),Male,33,98,86,239,133,64,0,653
Influenza (J10-J11),Female,46,151,134,357,206,86,0,980
Pneumonia (J12-J18),Male,1603,2028,1357,2459,2916,1488,16,11867
Pneumonia (J12-J18),Female,1144,1783,1249,1962,2378,1414,4,9934
Acute bronchitis (J20),Male,1296,2425,1931,2657,2346,1019,23,11697
Acute bronchitis (J20),Female,1175,2240,2022,3144,2744,1310,31,12666
Acute bronchiolitis (J21),Male,8435,1713,698,538,497,224,29,12134
Acute bronchiolitis (J21),Female,6079,1272,492,615,550,291,2,9301
Other diseases of the upper respiratory tract (J30-J39),Male,1137,2180,2502,4819,2883,1143,22,14686
Other diseases of the upper respiratory tract (J30-J39),Female,926,1702,2128,5086,2734,1138,19,13733
"Bronchitis, emphysema and other chronic obstructive pulmonary disease (J40-J44)",Male,600,490,735,3008,12485,9102,21,26441
"Bronchitis, emphysema and other chronic obstructive pulmonary disease (J40-J44)",Female,439,485,632,1877,2732,2042,11,8218
Asthma (J45-J46),Male,591,7743,16105,20869,29534,17925,138,92905
Asthma (J45-J46),Female,370,6145,12686,28428,28729,16496,196,93050
Bronchiectasis (J47),Male,0,0,188,522,853,518,4,2085
Bronchiectasis (J47),Female,0,0,144,547,1076,736,7,2510
"Other diseases of the respiratory system(J22,J60-J98)",Male,10691,21344,13886,16693,18322,10192,43,91171
"Other diseases of the respiratory system(J22,J60-J98)",Female,8030,18005,12003,17171,18186,11159,39,84593
Diseases of teeth and supporting structure (K00-K08),Male,17,636,1396,2120,964,328,4,5465
Diseases of teeth and supporting structure (K00-K08),Female,26,531,1112,1968,955,315,2,4909
"Other diseases of the oral cavity, salivary glands and jaws (K09-K14)",Male,65,292,676,1398,984,297,1,3713
"Other diseases of the oral cavity, salivary glands and jaws (K09-K14)",Female,61,253,498,1047,615,179,1,2654
"Gastric and duodenal ulcer, peptic ulcer site unspecified and gastrojejunal ulcer (K25-K28)",Male,1,72,438,2041,1271,512,3,4338
"Gastric and duodenal ulcer, peptic ulcer site unspecified and gastrojejunal ulcer (K25-K28)",Female,3,73,476,2171,1187,447,7,4364
Gastritis and duodenitis (K29),Male,55,1306,5355,27392,15678,5947,125,55858
Gastritis and duodenitis (K29),Female,57,1274,7987,30994,16224,7118,109,63763
"Other diseases of oesophagus, stomach and duodenum (K20-K22,K30-K31)",Male,70,259,775,5632,3595,1283,9,11623
"Other diseases of oesophagus, stomach and duodenum (K20-K22,K30-K31)",Female,59,262,1037,6022,3903,1565,15,12863
Diseases of appendix (K35-K38),Male,8,204,3411,7876,1438,310,2,13249
Diseases of appendix (K35-K38),Female,5,151,2855,5913,1345,315,2,10586
Hernia (K40-K46),Male,329,933,1247,8861,9689,3771,8,24838
Hernia (K40-K46),Female,169,542,703,3587,2964,776,6,8747
Noninfective enteritis and colitis (K50-K52),Male,152,447,417,757,392,213,1,2379
Noninfective enteritis and colitis (K50-K52),Female,123,392,366,1035,433,211,0,2560
Other diseases of intestines and peritoneum (K55-K66),Male,436,948,964,6176,4699,2078,8,15309
Other diseases of intestines and peritoneum (K55-K66),Female,335,734,983,4425,2701,1447,11,10636
Alcoholic liver disease (K70),Male,0,1,3,2430,2699,504,10,5647
Alcoholic liver disease (K70),Female,0,0,2,108,214,345,2,671
Other diseases of liver (K71-K76),Male,33,52,183,2004,3202,750,6,6230
Other diseases of liver (K71-K76),Female,17,42,137,555,1153,590,4,2498
"Cholelithiasis and cholecystitis (K80,K81)",Male,6,20,58,618,697,205,1,1605
"Cholelithiasis and cholecystitis (K80,K81)",Female,9,24,68,1539,971,299,0,2910
"Acute pancreatitis and other diseases of the pancreas (K85,K86)",Male,2,18,83,1657,885,89,0,2734
"Acute pancreatitis and other diseases of the pancreas (K85,K86)",Female,7,15,67,340,195,63,0,687
"Other diseases of the digestive system (K82-K83,K90-K92)",Male,160,384,768,2459,1764,820,8,6363
"Other diseases of the digestive system (K82-K83,K90-K92)",Female,186,511,785,2055,1311,741,3,5592
Infections of skin and subcutaneous tissue (L00-L08),Male,1334,5151,8641,29353,22864,8756,138,76237
Infections of skin and subcutaneous tissue (L00-L08),Female,1469,4897,5799,19014,17183,6772,37,55171
Other diseases of skin and subcutaneous tissue (L10-L98),Male,769,2480,4100,13704,10585,3740,19,35397
Other diseases of skin and subcutaneous tissue (L10-L98),Female,686,2027,3657,11398,7891,2540,25,28224
"Disorders of joints (M00-M02,M15-M25)",Male,35,420,1469,6079,4227,1853,10,14093
"Disorders of joints (M00-M02,M15-M25)",Female,29,312,1088,4305,5339,2108,8,13189
Rheumatoid arthritis and other inflamatory polyarthropathies (M05-M13),Male,5,89,325,951,1122,558,2,3052
Rheumatoid arthritis and other inflamatory polyarthropathies (M05-M13),Female,5,58,280,1552,2292,809,10,5006
Systemic connective tissue disorders (M30-M35),Male,11,27,102,218,135,28,0,521
Systemic connective tissue disorders (M30-M35),Female,7,24,145,1044,304,63,0,1587
Soft tissue disorders (M60-M79),Male,34,289,2665,12912,7515,2515,35,25965
Soft tissue disorders (M60-M79),Female,16,235,1975,9275,6825,2670,212,21208
Osteomyelitis (M86),Male,9,13,77,536,348,94,3,1080
Osteomyelitis (M86),Female,7,6,70,243,296,106,0,728
"Other disorders of musculoskeletal system (M40-M54, M80-M85,M87-M99)",Male,21,140,2319,18429,11982,4486,57,37434
"Other disorders of musculoskeletal system (M40-M54, M80-M85,M87-M99)",Female,22,110,1957,14385,11813,5160,66,33513
Glomerular diseases (N00-N07),Male,13,502,1295,1115,1034,341,5,4305
Glomerular diseases (N00-N07),Female,7,329,905,1105,626,175,1,3148
Infections of the kidney (N10-N12),Male,33,170,394,1689,1422,549,0,4257
Infections of the kidney (N10-N12),Female,23,145,354,2909,1582,509,1,5523
Renal failure (N17-N19),Male,4,65,307,4294,7839,3113,5,15627
Renal failure (N17-N19),Female,5,46,229,2252,3508,1518,2,7560
Urolithiasis (N20-N23),Male,10,174,615,20602,7728,1307,9,30445
Urolithiasis (N20-N23),Female,7,92,443,6536,3428,626,4,11136
Diseases of breast (N60-N64),Male,52,47,133,617,293,105,0,1247
Diseases of breast (N60-N64),Female,104,90,453,7308,2106,380,4,10445
"Other diseases of the urinary system (N13-N15, N25-N28,N30-N39,N99.0,N99.1,N99.4,N99.5)",Male,2089,3548,4915,21428,17041,10293,179,59493
"Other diseases of the urinary system (N13-N15, N25-N28,N30-N39,N99.0,N99.1,N99.4,N99.5)",Female,1545,3423,4948,30596,16177,7728,54,64471
Hyperplasia of prostate (N40),Male,7,29,74,446,1703,2137,25,4421
Hyperplasia of prostate (N40),Female,0,0,0,0,0,0,0,0
Hydrocele and spermatocele (N43),Male,19,254,246,861,884,272,11,2547
Hydrocele and spermatocele (N43),Female,0,0,0,0,0,0,0,0
"Other diseases of the male genital organs (N41,N42,N44-N50)",Male,182,1349,2262,5100,3026,1220,8,13147
"Other diseases of the male genital organs (N41,N42,N44-N50)",Female,0,0,0,0,0,0,0,0
Salpingitis and oophoritis (N70),Male,0,0,0,0,0,0,0,0
Salpingitis and oophoritis (N70),Female,10,22,78,340,124,28,2,604
Female genital prolapse (N81),Male,0,0,0,0,0,0,0,0
Female genital prolapse (N81),Female,1,32,82,2951,3428,1114,3,7611
"Other disorders of the female genito-urinary system (N71-N80,N82-N98,N99.2,N99.3)",Male,0,0,0,0,0,0,0,0
"Other disorders of the female genito-urinary system (N71-N80,N82-N98,N99.2,N99.3)",Female,81,235,2107,54581,13476,1938,18,72436
Abortions (O00-O08),Male,0,0,0,0,0,0,0,0
Abortions (O00-O08),Female,0,0,341,48886,371,0,45,49643
"Oedema, proteinuria and hypertensive disorders in pregnancy, childbirth and the puerperium (O10-O16)",Male,0,0,0,0,0,0,0,0
"Oedema, proteinuria and hypertensive disorders in pregnancy, childbirth and the puerperium (O10-O16)",Female,0,0,285,12261,0,0,40,12586
Supervision of high risk pregnancy (Z35),Male,0,0,0,0,0,0,0,0
Supervision of high risk pregnancy (Z35),Female,0,0,87,7675,0,0,15,7777
"Placenta praevia, premature separation of placenta and antepartum haemorrhage (O44-O46)",Male,0,0,0,0,0,0,0,0
"Placenta praevia, premature separation of placenta and antepartum haemorrhage (O44-O46)",Female,0,0,30,2671,0,0,19,2720
False Labour (O47),Male,0,0,0,0,0,0,0,0
False Labour (O47),Female,0,0,87,11634,0,0,8,11729
Those admitted and discharged before delivery (Distance from hospital etc.),Male,0,0,0,0,0,0,0,0
Those admitted and discharged before delivery (Distance from hospital etc.),Female,0,0,102,21052,0,0,10,21164
"Other Maternal care related to fetus and amniotic cavity and possible  delivery problems (O30-O43,O48) * (Includes still births)",Male,0,0,0,0,0,0,0,0
"Other Maternal care related to fetus and amniotic cavity and possible  delivery problems (O30-O43,O48) * (Includes still births)",Female,0,0,121,21584,0,0,42,21747
Obstructed Labour (O64-O66),Male,0,0,0,0,0,0,0,0
Obstructed Labour (O64-O66),Female,0,0,28,583,0,0,6,617
Post parturm haemorrhage (O72),Male,0,0,0,0,0,0,0,0
Post parturm haemorrhage (O72),Female,0,0,8,1999,0,0,7,2014
Single spontaneous delivery (O80),Male,0,0,0,0,0,0,0,0
Single spontaneous delivery (O80),Female,0,0,753,221714,0,0,99,222566
"Other  complications of pregnancy and delivery (020-029,060-063,067-071,073-075,081-084)",Male,0,0,0,0,0,0,0,0
"Other  complications of pregnancy and delivery (020-029,060-063,067-071,073-075,081-084)",Female,0,0,686,177818,0,0,160,178664
Complications predominantly related to the puerperium (O85-O92),Male,0,0,0,0,0,0,0,0
Complications predominantly related to the puerperium (O85-O92),Female,0,0,53,2551,0,0,38,2642
Other obstetric conditions not elsewhere classified (O95-O99),Male,0,0,0,0,0,0,0,0
Other obstetric conditions not elsewhere classified (O95-O99),Female,0,0,85,11466,0,0,36,11587
"Fetus and newborn affected by maternal factors and by complications of pregnancy, labour and delivery (P00-P04)",Male,333,23,0,0,0,0,3,359
"Fetus and newborn affected by maternal factors and by complications of pregnancy, labour and delivery (P00-P04)",Female,386,29,0,0,0,0,219,634
"Slow fetal growth, fetal malnutrition and disorders related to short gestation and low birth weight (P05-P07)",Male,3338,81,0,0,0,0,9,3428
"Slow fetal growth, fetal malnutrition and disorders related to short gestation and low birth weight (P05-P07)",Female,3337,99,0,0,0,0,38,3474
Birth trauma (P10-P15),Male,39,10,0,0,0,0,6,55
Birth trauma (P10-P15),Female,53,14,0,0,0,0,4,71
"Intrauterine hypoxia, birth asphyxia and other respiratory disorders originating in the perinatal period (P20-P28)",Male,3416,313,0,0,0,0,18,3747
"Intrauterine hypoxia, birth asphyxia and other respiratory disorders originating in the perinatal period (P20-P28)",Female,2741,237,0,0,0,0,14,2992
Haemolytic disease of fetus and new born (P55),Male,140,12,0,0,0,0,1,153
Haemolytic disease of fetus and new born (P55),Female,161,21,0,0,0,0,4,186
"Other conditions originating in the perinatal period (P08,P29,P35.1-P39,P50-P54,P56-P96)",Male,11499,378,0,0,0,0,89,11966
"Other conditions originating in the perinatal period (P08,P29,P35.1-P39,P50-P54,P56-P96)",Female,10489,301,0,0,0,0,189,10979
"Congenital hydrocephalus and spina bifida (Q03,Q05)",Male,69,30,5,1,0,0,1,106
"Congenital hydrocephalus and spina bifida (Q03,Q05)",Female,60,18,5,64,0,0,0,147
"Other congenital malformations of the nervous system (Q00-Q02,Q04,Q06,Q07)",Male,53,27,3,65,1,0,0,149
"Other congenital malformations of the nervous system (Q00-Q02,Q04,Q06,Q07)",Female,46,18,8,13,2,1,0,88
Congenital malformations of the circulatory system (Q20-Q28),Male,737,371,253,184,58,7,1,1611
Congenital malformations of the circulatory system (Q20-Q28),Female,640,436,297,362,110,13,6,1864
Cleft lip and cleft palate (Q35-Q37),Male,300,330,70,31,4,0,3,738
Cleft lip and cleft palate (Q35-Q37),Female,252,284,76,38,1,0,0,651
"Other congenital malformations and deformations (Q10-Q18,Q30-Q34,Q38-Q89)",Male,1316,1981,878,260,58,18,2,4513
"Other congenital malformations and deformations (Q10-Q18,Q30-Q34,Q38-Q89)",Female,816,734,376,231,61,7,1,2226
"Chromosomal abnormalities, not elsewhere classified (Q90-Q99)",Male,72,29,10,6,0,1,1,119
"Chromosomal abnormalities, not elsewhere classified (Q90-Q99)",Female,68,37,21,11,1,1,0,139
Symptoms and signs involving the circulatory and respiratory systems (R00-R09),Male,1423,2866,4934,21258,19471,7496,76,57524
Symptoms and signs involving the circulatory and respiratory systems (R00-R09),Female,1037,2162,4751,20493,19275,7907,39,55664
Symptoms and signs involving the digestive system and abdomen (R10-R19),Male,1165,3283,9576,30086,14202,4970,33,63315
Symptoms and signs involving the digestive system and abdomen (R10-R19),Female,1181,3057,10416,40340,12959,5024,36,73013
Symptoms and signs involving the skin and subcutaneous tissue (R20-R23),Male,275,738,1238,3368,1698,641,5,7963
Symptoms and signs involving the skin and subcutaneous tissue (R20-R23),Female,266,655,1102,3098,1763,561,2,7447
Fever of unknown origin (R50),Male,1493,3091,3957,11266,4786,1447,552,26592
Fever of unknown origin (R50),Female,1208,2394,3065,8044,4379,1602,15,20707
Headache (R51),Male,0,176,1632,5066,2817,955,13,10659
Headache (R51),Female,0,180,1883,7354,3959,1373,11,14760
Senility (R54),Male,0,0,0,0,0,528,0,528
Senility (R54),Female,0,0,0,0,0,609,0,609
"Convulsions, not elsewhere classified (R56)",Male,2078,7832,2648,2254,1170,529,21,16532
"Convulsions, not elsewhere classified (R56)",Female,1861,6159,2046,1670,862,522,8,13128
"Other signs and symptoms and abnormal clinical findings (R25-R49,R52,R53,R55,R57-R69)",Male,2606,3303,6288,20343,18285,10598,89,61512
"Other signs and symptoms and abnormal clinical findings (R25-R49,R52,R53,R55,R57-R69)",Female,2276,2640,5736,22646,17839,9487,47,60671
Abnormal findings in investigations not elsewhere classified (R70-R94),Male,85,165,246,554,618,271,2,1941
Abnormal findings in investigations not elsewhere classified (R70-R94),Female,75,110,210,657,513,217,6,1788
Ill-defined and unknown causes of mortality (R95-R99),Male,18,52,233,600,189,39,4,1135
Ill-defined and unknown causes of mortality (R95-R99),Female,6,36,65,161,79,22,2,371
"Superficial injury (S00,S10,S20,S30,S40,S50,S60,S70,S80,S90, T00,T09.0,T11.0,T13.0,T14.0)",Male,805,7631,23697,80885,22381,5596,233,141228
"Superficial injury (S00,S10,S20,S30,S40,S50,S60,S70,S80,S90, T00,T09.0,T11.0,T13.0,T14.0)",Female,767,5719,11940,32967,13504,4708,113,69718
"Fractures (S02,S12,S22,S32,S42,S52,S62,S72,S82,S92, T02,T08,T10,T12,T14.2)",Male,194,2066,12563,33506,11571,3561,75,63536
"Fractures (S02,S12,S22,S32,S42,S52,S62,S72,S82,S92, T02,T08,T10,T12,T14.2)",Female,159,1629,4599,9585,8921,6046,24,30963
"Dislocations, sprains and strains (S03,S13,S23,S33,S43,S53,S63,S73,S83,S93, T03,T09.2,T11.2,T13.2,T14.3)",Male,35,202,899,5378,1717,386,21,8638
"Dislocations, sprains and strains (S03,S13,S23,S33,S43,S53,S63,S73,S83,S93, T03,T09.2,T11.2,T13.2,T14.3)",Female,54,151,444,1771,1088,576,2,4086
Injury to eye and orbit (S05),Male,69,823,2648,6913,2735,541,6,13735
Injury to eye and orbit (S05),Female,59,573,1162,2608,1635,443,3,6483
Intracranial injuries (S06),Male,89,332,695,2239,864,296,87,4602
Intracranial injuries (S06),Female,65,296,404,924,455,227,16,2387
"Injury of other internal organs (S26,S27,S36,S37)",Male,28,120,316,1296,467,92,4,2323
"Injury of other internal organs (S26,S27,S36,S37)",Female,14,90,193,485,231,68,0,1081
"Crushing injuries and traumatic amputations (S07,S08,S17,S18,S28,S38,S47,S48, S57,S58,S67,S68,S77,S78,S87,S88,S97,S98,T04,T05,   T09.6,T11.6,T13.6,T14.7)",Male,101,869,2029,8421,3357,856,8,15641
"Crushing injuries and traumatic amputations (S07,S08,S17,S18,S28,S38,S47,S48, S57,S58,S67,S68,S77,S78,S87,S88,S97,S98,T04,T05,   T09.6,T11.6,T13.6,T14.7)",Female,93,659,1210,2585,1565,629,5,6746
"Open wounds and injuries to blood vessels (S01,S11,S15,S21,S25,S31,S35,S41,S45, S51, S55,S61,S65,S71,S75,S81,S85,S91,S95,T01,T06.3,T09.1,T11.1,T11.4,T13.1,  T13.4,  T14.1,  T14.5)",Male,674,7662,23803,78088,26391,7155,242,144015
"Open wounds and injuries to blood vessels (S01,S11,S15,S21,S25,S31,S35,S41,S45, S51, S55,S61,S65,S71,S75,S81,S85,S91,S95,T01,T06.3,T09.1,T11.1,T11.4,T13.1,  T13.4,  T14.1,  T14.5)",Female,551,5397,10518,27674,14294,5053,85,63572
"Injuries to nerves (S04,S14,S24,S34,S44,S54,  S64,S74,S84,S94,T06.2, T11.3,T13.3,T14.4)",Male,13,64,179,576,246,45,1,1124
"Injuries to nerves (S04,S14,S24,S34,S44,S54,  S64,S74,S84,S94,T06.2, T11.3,T13.3,T14.4)",Female,5,68,113,184,90,28,1,489
Bitten or struck by dog (W54),Male,131,3331,11548,15962,8406,2317,10,41705
Bitten or struck by dog (W54),Female,111,2285,6805,11423,7342,2063,18,30047
"Other injuries of specified, unspecified and multiple body regions (S09,S16,S19,S29,S39,S46,S49,S56, S59,S66,S69,S76,S79, S86,S89,S96,S99,T06.0,T06.1,T06.4-T06.8, T07,T09.3-TO9.5,T09.8,T09.9,T11.5, T11.8,T11.9,T13.5,T13.8,T13.9, T14.6,T14.8,T14.9)",Male,878,6779,18200,65014,18776,4919,304,114870
"Other injuries of specified, unspecified and multiple body regions (S09,S16,S19,S29,S39,S46,S49,S56, S59,S66,S69,S76,S79, S86,S89,S96,S99,T06.0,T06.1,T06.4-T06.8, T07,T09.3-TO9.5,T09.8,T09.9,T11.5, T11.8,T11.9,T13.5,T13.8,T13.9, T14.6,T14.8,T14.9)",Female,817,5326,8721,25272,10885,4655,98,55774
Effects of foregin body entering through orifice (T15-T19),Male,343,5005,4688,11581,3335,684,12,25648
Effects of foregin body entering through orifice (T15-T19),Female,360,5224,3616,6678,3429,797,2,20106
Burns and corrosion confined to eye and adnexa (T26),Male,25,227,279,909,302,38,2,1782
Burns and corrosion confined to eye and adnexa (T26),Female,14,175,229,452,196,57,0,1123
"All other burns and corrosions (T20-T25,T27-T32)",Male,222,1678,1174,2757,762,189,5,6787
"All other burns and corrosions (T20-T25,T27-T32)",Female,174,1438,946,2053,676,214,1,5502
"Poisoning by drugs, medicaments and biological substances (T36-T50)",Male,88,1017,1468,7786,1305,354,14,12032
"Poisoning by drugs, medicaments and biological substances (T36-T50)",Female,104,851,3016,11642,945,303,6,16867
Toxic effects of organophosphate and carbamate insecticides (T60.0),Male,19,221,558,6200,1423,250,24,8695
Toxic effects of organophosphate and carbamate insecticides (T60.0),Female,25,190,774,4022,524,161,10,5706
Toxic effects of other pesticides (T60.1-T60.9),Male,25,209,298,2602,483,85,8,3710
Toxic effects of other pesticides (T60.1-T60.9),Female,26,171,375,1699,195,51,3,2520
Snake bites (T63.0),Male,88,650,2996,13718,5873,1053,13,24391
Snake bites (T63.0),Female,60,520,2138,8160,4285,810,9,15982
"Toxic effects of other substances chiefly non medicinal as to source (T51-T59,T61,T62,T63.1-T63.9,T64,T65)",Male,211,1753,2562,8985,2712,644,23,16890
"Toxic effects of other substances chiefly non medicinal as to source (T51-T59,T61,T62,T63.1-T63.9,T64,T65)",Female,161,1280,2337,7936,2093,470,23,14300
"Other unspecified effects of external causes (T33-T35,T66-T78)",Male,460,1702,3574,7636,2730,755,21,16878
"Other unspecified effects of external causes (T33-T35,T66-T78)",Female,350,1299,4099,7563,2768,770,18,16867
Certain early complications of trauma (T79),Male,57,231,788,3249,2220,828,8,7381
Certain early complications of trauma (T79),Female,43,183,401,1626,1488,626,2,4369
Complications of surgical and medical care not elsewhere classified (T80-T88),Male,196,371,717,2057,1273,486,11,5111
Complications of surgical and medical care not elsewhere classified (T80-T88),Female,188,334,617,2208,1139,394,5,4885
"Sequelae of injuries, poisoning and of other consequences of external causes (T90-T98)",Male,36,144,386,1328,608,174,2,2678
"Sequelae of injuries, poisoning and of other consequences of external causes (T90-T98)",Female,43,125,248,848,358,150,1,1773
"Persons encountering health services for examination, investigation and for specific procedures of health care (Z00-Z13,Z40-Z54)",Male,10051,18650,34057,89992,77263,35741,526,266280
"Persons encountering health services for examination, investigation and for specific procedures of health care (Z00-Z13,Z40-Z54)",Female,8539,13642,24828,109971,57646,22893,404,237923
Sterilization (Z30.2)(admissions only for sterilization),Male,0,0,0,143,45,0,13,201
Sterilization (Z30.2)(admissions only for sterilization),Female,0,0,0,6204,326,0,11,6541
Undiagnosed / Uncoded,Male,4597,7191,15905,82468,56971,21087,508,188727
Undiagnosed / Uncoded,Female,4570,6410,12682,88951,46455,18076,470,177614
Total,Male,107506,215394,355936,1125478,751493,314186,5317,2875310
Total,Female,90463,176797,271318,1514981,657834,290657,4526,3006576
